1111111111111111
1000000001000001
1111100011000001
1000100100001001
1000100000010001
1000100011100001
1110100110001101
1000001000010001
1000010000010001
1111111111111111