1111111111
1000000001
1111100011
1000100101
1000100001
1000100011
1110100111
1000001001
1000000001
1111111111